100
06 12 06 12 06 12 06 12 06 12 06 12 06 12 06 12 06 12 06 12 06 12 06 12 06 12 06 12 06 12
06 12 00 12 00 12 00 12 00 12 00 12 00 12 00 12 00 12 00 12 00 12 00 12 00 12 00 12 06 12
06 12 04 12 04 07 00 12 00 12 00 12 00 12 00 12 00 12 00 12 00 12 00 12 00 12 00 12 06 12
06 12 04 12 04 12 00 12 00 12 02 12 02 12 00 12 00 12 00 12 00 12 00 12 00 12 00 12 06 12
06 12 04 12 04 01 00 12 00 12 02 12 02 12 02 12 02 03 00 12 00 12 00 12 03 12 03 12 06 12
06 12 00 12 00 12 00 12 00 12 02 12 02 12 02 12 02 03 00 12 03 12 03 12 03 12 03 12 06 12
06 12 00 12 00 12 01 12 00 12 00 12 00 12 00 12 00 12 00 12 03 12 03 12 03 12 03 12 06 12
06 12 00 12 00 12 01 08 00 12 00 12 00 12 00 12 00 12 00 12 03 12 03 12 03 10 03 08 06 12
06 12 00 12 00 12 01 08 00 12 00 12 00 12 00 12 00 12 00 12 00 12 00 12 00 12 00 12 06 12
06 12 00 12 00 12 01 12 00 12 00 12 00 12 00 12 00 12 00 12 00 12 00 12 00 12 00 12 06 12
06 12 00 12 00 12 00 12 00 12 00 12 00 12 00 12 00 12 00 12 00 12 00 12 00 12 00 12 06 12
06 12 00 12 00 12 00 12 00 12 00 12 00 12 00 12 00 12 00 12 00 12 00 12 00 12 00 12 06 12
06 12 00 12 00 12 00 12 00 12 01 12 01 06 01 03 01 07 00 12 00 12 00 12 00 12 00 12 06 12
06 12 00 12 00 12 00 12 00 12 00 12 01 02 00 12 01 00 00 12 00 12 00 12 00 12 00 12 06 12
06 12 06 12 06 12 06 12 06 12 06 12 06 12 06 12 06 12 06 12 06 12 06 12 06 12 06 12 06 12

Ściąga do tworzenia mapy :P

left	up	right	down	corner1	corner2	corner3	corner4	cornerBig1	cornerBig2	cornerBig3	cornerBig4	full
0		1	2		3		4		5		6		7		8			9			10			11			12

air	brick	stone	green	water	road	endMap	kurak	kurakDEAD	(PS: Kuraków nie można umieszczać!!!)
0	1		2		3		4		5		6		7		8